id,player_name,age,games,games_started,minutes_played,field_goals,field_attempts,field_percent,three_fg,three_attempts,three_percent,two_fg,two_attempts,two_percent,effect_fg_percent,ft,fta,ft_percent,ORB,DRB,TRB,AST,STL,BLK,TOV,PF,PTS,team,season
576,Bol Bol,23,70,33,1505,261,478,0.546,30,113,0.265,231,365,0.633,0.577,82,108,0.759,69,336,405,69,30,85,112,92,634,ORL,2023
863,Bol Bol,22,14,0,81,15,27,0.556,1,4,0.25,14,23,0.609,0.574,2,5,0.4,4,16,20,5,1,2,4,4,33,DEN,2022
1562,Bol Bol,21,32,2,160,25,58,0.431,9,24,0.375,16,34,0.471,0.509,10,15,0.667,0,24,24,7,3,10,13,14,69,DEN,2021
2156,Bol Bol,20,7,0,87,14,28,0.5,4,9,0.444,10,19,0.526,0.571,8,10,0.8,5,14,19,6,2,6,10,11,40,DEN,2020
75,Royce O'Neale,29,76,53,2409,229,593,0.386,163,419,0.389,66,174,0.379,0.524,50,69,0.725,55,329,384,283,65,49,114,239,671,BRK,2023
912,Royce O'Neale,28,77,77,2406,203,444,0.457,119,306,0.389,84,138,0.609,0.591,45,56,0.804,64,304,368,191,86,32,79,183,570,UTA,2022
1603,Royce O'Neale,27,71,71,2241,175,394,0.444,107,278,0.385,68,116,0.586,0.58,39,46,0.848,88,397,485,181,57,32,83,182,496,UTA,2021
2209,Royce O'Neale,26,71,62,2049,158,365,0.433,92,244,0.377,66,121,0.545,0.559,42,55,0.764,27,362,389,180,59,32,61,202,450,UTA,2020
2820,Royce O'Neale,25,82,16,1671,163,343,0.475,68,176,0.386,95,167,0.569,0.574,32,42,0.762,22,263,285,124,54,24,70,172,426,UTA,2019
3435,Royce O'Neale,24,69,4,1150,120,284,0.423,42,118,0.356,78,166,0.47,0.496,61,76,0.803,25,211,236,95,36,16,55,105,343,UTA,2018
290,Nassir Little,22,54,4,976,134,303,0.442,58,158,0.367,76,145,0.524,0.538,33,46,0.717,27,114,141,50,20,20,36,66,359,POR,2023
943,Nassir Little,21,42,23,1088,145,315,0.46,51,154,0.331,94,161,0.584,0.541,69,94,0.734,58,178,236,54,25,36,40,82,410,POR,2022
1632,Nassir Little,20,48,2,640,78,167,0.467,28,80,0.35,50,87,0.575,0.551,36,45,0.8,32,96,128,23,5,13,18,51,220,POR,2021
2235,Nassir Little,19,48,5,573,65,151,0.43,14,59,0.237,51,92,0.554,0.477,28,44,0.636,31,77,108,22,13,14,15,72,172,POR,2020
108,Thaddeus Young,34,54,9,795,108,198,0.545,6,34,0.176,102,164,0.622,0.561,18,26,0.692,71,95,166,75,54,5,42,88,240,TOR,2023
738,Thaddeus Young,33,26,0,475,67,144,0.465,17,43,0.395,50,101,0.495,0.524,13,27,0.481,40,75,115,45,31,11,22,43,164,TOR,2022
837,Thaddeus Young,33,26,1,370,74,128,0.578,0,5,0.0,74,123,0.602,0.578,10,22,0.455,40,53,93,59,23,7,30,38,158,SAS,2022
1688,Thaddeus Young,32,68,23,1652,370,662,0.559,12,45,0.267,358,617,0.58,0.568,71,113,0.628,168,255,423,291,74,40,137,152,823,CHI,2021
2285,Thaddeus Young,31,64,16,1591,269,601,0.448,79,222,0.356,190,379,0.501,0.513,42,72,0.583,94,221,315,117,92,23,102,134,659,CHI,2020
2924,Thaddeus Young,30,81,81,2489,443,841,0.527,51,146,0.349,392,695,0.564,0.557,87,135,0.644,192,331,523,204,123,36,123,194,1024,IND,2019
3534,Thaddeus Young,29,81,81,2607,421,864,0.487,58,181,0.32,363,683,0.531,0.521,55,92,0.598,184,328,512,152,135,36,105,175,955,IND,2018
4105,Thaddeus Young,28,74,74,2237,362,687,0.527,45,118,0.381,317,569,0.557,0.56,45,86,0.523,131,317,448,122,113,29,95,135,814,IND,2017
4380,Thaddeus Young,27,73,73,2407,495,963,0.514,7,30,0.233,488,933,0.523,0.518,105,163,0.644,176,484,660,136,112,37,136,182,1102,BRK,2016
4935,Thaddeus Young,26,28,20,829,162,327,0.495,19,50,0.38,143,277,0.516,0.524,43,71,0.606,52,114,166,38,38,8,42,56,386,BRK,2015
5059,Thaddeus Young,26,48,48,1605,289,641,0.451,19,65,0.292,270,576,0.469,0.466,88,129,0.682,75,170,245,135,86,17,75,115,685,MIN,2015
5432,Thaddeus Young,25,79,78,2718,582,1283,0.454,90,292,0.308,492,991,0.496,0.489,163,229,0.712,166,310,476,182,167,36,165,213,1417,PHI,2014
5984,Thaddeus Young,24,76,76,2629,509,958,0.531,1,8,0.125,508,950,0.535,0.532,108,188,0.574,182,389,571,125,133,55,90,191,1127,PHI,2013
6506,Thaddeus Young,23,63,1,1755,348,687,0.507,1,4,0.25,347,683,0.508,0.507,111,144,0.771,137,188,325,74,64,41,55,127,808,PHI,2012
7023,Thaddeus Young,22,82,1,2135,458,847,0.541,6,22,0.273,452,825,0.548,0.544,123,174,0.707,153,281,434,82,90,26,99,170,1045,PHI,2011
7565,Thaddeus Young,21,67,45,2145,382,813,0.47,48,138,0.348,334,675,0.495,0.499,114,165,0.691,130,220,350,97,81,15,126,133,926,PHI,2010
8073,Thaddeus Young,20,75,71,2580,475,960,0.495,56,164,0.341,419,796,0.526,0.524,139,189,0.735,139,238,377,86,100,23,118,165,1145,PHI,2009
8596,Thaddeus Young,19,74,22,1554,264,490,0.539,6,19,0.316,258,471,0.548,0.545,76,103,0.738,120,192,312,58,73,8,64,126,610,PHI,2008
431,Josh Okogie,24,72,26,1350,162,414,0.391,66,197,0.335,96,217,0.442,0.471,139,192,0.724,109,142,251,105,56,34,63,114,529,PHO,2023
879,Josh Okogie,23,49,6,516,42,104,0.404,14,47,0.298,28,57,0.491,0.471,35,51,0.686,29,41,70,25,26,12,23,53,133,MIN,2022
1571,Josh Okogie,22,59,37,1197,102,254,0.402,29,108,0.269,73,146,0.5,0.459,83,108,0.769,63,93,156,63,54,28,43,123,316,MIN,2021
2163,Josh Okogie,21,62,28,1547,170,398,0.427,41,154,0.266,129,244,0.529,0.479,152,191,0.796,87,181,268,99,68,26,87,139,533,MIN,2020
2777,Josh Okogie,20,74,52,1757,196,508,0.386,60,215,0.279,136,293,0.464,0.445,118,162,0.728,41,177,218,91,88,33,63,166,570,MIN,2019
37,Saben Lee,23,2,0,10,3,4,0.75,0,1,0.0,3,3,1.0,0.75,0,0,,0,0,0,2,1,0,3,1,6,PHI,2023
441,Saben Lee,23,23,1,363,46,117,0.393,11,29,0.379,35,88,0.398,0.44,42,57,0.737,13,32,45,65,18,1,21,31,145,PHO,2023
1080,Saben Lee,22,37,0,604,69,177,0.39,14,60,0.233,55,117,0.47,0.429,56,71,0.789,18,69,87,107,36,12,36,44,208,DET,2022
1735,Saben Lee,21,48,7,781,99,210,0.471,8,23,0.348,91,187,0.487,0.49,61,89,0.685,20,77,97,174,32,13,55,76,267,DET,2021
183,Keita Bates-Diop,27,67,42,1452,236,465,0.508,56,142,0.394,180,323,0.557,0.568,119,150,0.793,65,183,248,103,46,20,56,63,647,SAS,2023
831,Keita Bates-Diop,26,59,14,956,136,263,0.517,17,55,0.309,119,208,0.572,0.549,46,61,0.754,62,169,231,41,27,14,45,61,335,SAS,2022
1539,Keita Bates-Diop,25,30,0,245,30,67,0.448,5,17,0.294,25,50,0.5,0.485,14,21,0.667,9,40,49,12,11,5,7,11,79,SAS,2021
2155,Keita Bates-Diop,24,7,0,98,13,28,0.464,3,9,0.333,10,19,0.526,0.518,8,10,0.8,4,13,17,0,2,4,3,7,37,DEN,2020
2172,Keita Bates-Diop,24,37,0,646,87,206,0.422,31,94,0.33,56,112,0.5,0.498,46,65,0.708,21,89,110,30,17,20,14,36,251,MIN,2020
2787,Keita Bates-Diop,23,30,3,503,60,142,0.423,13,52,0.25,47,90,0.522,0.468,18,28,0.643,16,67,83,17,18,14,14,29,151,MIN,2019
288,Jusuf Nurkić,28,52,52,1391,262,505,0.519,43,119,0.361,219,386,0.567,0.561,127,192,0.661,114,357,471,149,43,44,119,185,694,POR,2023
937,Jusuf Nurkić,27,56,56,1579,321,600,0.535,15,56,0.268,306,544,0.563,0.548,185,268,0.69,167,452,619,157,62,34,143,189,842,POR,2022
1630,Jusuf Nurkić,26,37,37,880,171,333,0.514,12,30,0.4,159,303,0.525,0.532,70,113,0.619,86,246,332,125,38,39,73,103,424,POR,2021
2240,Jusuf Nurkić,25,8,8,253,54,109,0.495,2,10,0.2,52,99,0.525,0.505,31,35,0.886,23,59,82,32,11,16,19,39,141,POR,2020
2835,Jusuf Nurkić,24,72,72,1974,420,826,0.508,3,29,0.103,417,797,0.523,0.51,282,365,0.773,243,505,748,233,71,103,168,250,1125,POR,2019
3453,Jusuf Nurkić,23,79,79,2088,480,951,0.505,0,7,0.0,480,944,0.508,0.505,172,273,0.63,189,519,708,143,64,111,183,247,1132,POR,2018
3970,Jusuf Nurkić,22,45,29,807,151,298,0.507,0,0,,151,298,0.507,0.507,56,113,0.496,89,171,260,60,25,36,81,88,358,DEN,2017
4039,Jusuf Nurkić,22,20,19,584,120,236,0.508,0,1,0.0,120,235,0.511,0.508,64,97,0.66,65,142,207,63,25,38,62,73,304,POR,2017
4505,Jusuf Nurkić,21,32,3,547,101,242,0.417,0,3,0.0,101,239,0.423,0.417,61,99,0.616,65,110,175,40,24,44,55,91,263,DEN,2016
5042,Jusuf Nurkić,20,62,27,1103,171,383,0.446,0,2,0.0,171,381,0.449,0.446,84,132,0.636,125,257,382,50,52,68,86,207,426,DEN,2015
79,Kevin Durant,34,39,39,1403,410,734,0.559,71,189,0.376,339,545,0.622,0.607,267,286,0.934,14,248,262,207,32,57,136,92,1158,BRK,2023
442,Kevin Durant,34,8,8,269,73,128,0.57,22,41,0.537,51,87,0.586,0.656,40,48,0.833,3,48,51,28,2,10,20,7,208,PHO,2023
704,Kevin Durant,33,55,55,2047,578,1115,0.518,115,300,0.383,463,815,0.568,0.57,372,409,0.91,29,378,407,351,48,52,191,113,1643,BRK,2022
1425,Kevin Durant,32,35,32,1157,324,603,0.537,85,189,0.45,239,414,0.577,0.608,210,238,0.882,13,234,247,195,25,45,120,70,943,BRK,2021
3004,Kevin Durant,30,78,78,2702,721,1383,0.521,137,388,0.353,584,995,0.587,0.571,448,506,0.885,33,464,497,457,58,84,225,155,2027,GSW,2019
3616,Kevin Durant,29,68,68,2325,630,1222,0.516,173,413,0.419,457,809,0.565,0.586,359,404,0.889,31,433,464,366,50,119,207,133,1792,GSW,2018
4173,Kevin Durant,28,62,62,2070,551,1026,0.537,117,312,0.375,434,714,0.608,0.594,336,384,0.875,39,474,513,300,66,99,138,117,1555,GSW,2017
4530,Kevin Durant,27,72,72,2578,698,1381,0.505,186,481,0.387,512,900,0.569,0.573,447,498,0.898,45,544,589,361,69,85,250,137,2029,OKC,2016
5090,Kevin Durant,26,27,27,913,238,467,0.51,64,159,0.403,174,308,0.565,0.578,146,171,0.854,16,162,178,110,24,25,74,40,686,OKC,2015
5637,Kevin Durant,25,81,81,3122,849,1688,0.503,192,491,0.391,657,1197,0.549,0.56,703,805,0.873,58,540,598,445,103,59,285,174,2593,OKC,2014
6185,Kevin Durant,24,81,81,3119,731,1433,0.51,139,334,0.416,592,1099,0.539,0.559,679,750,0.905,46,594,640,374,116,105,280,143,2280,OKC,2013
6702,Kevin Durant,23,66,66,2546,643,1297,0.496,133,344,0.387,510,953,0.535,0.547,431,501,0.86,40,487,527,231,88,77,248,133,1850,OKC,2012
7232,Kevin Durant,22,78,78,3038,711,1538,0.462,145,414,0.35,566,1124,0.504,0.509,594,675,0.88,57,476,533,214,88,76,218,159,2161,OKC,2011
7747,Kevin Durant,21,82,82,3239,794,1668,0.476,128,351,0.365,666,1317,0.506,0.514,756,840,0.9,105,518,623,231,112,84,271,171,2472,OKC,2010
8257,Kevin Durant,20,74,74,2885,661,1390,0.476,97,230,0.422,564,1160,0.486,0.51,452,524,0.863,77,405,482,205,96,53,225,134,1871,OKC,2009
8781,Kevin Durant,19,80,80,2768,587,1366,0.43,59,205,0.288,528,1161,0.455,0.451,391,448,0.873,70,278,348,192,78,75,232,122,1624,SEA,2008
7,Eric Gordon,34,47,47,1418,210,478,0.439,85,245,0.347,125,233,0.536,0.528,110,135,0.815,12,85,97,136,30,17,83,45,615,HOU,2023
476,Eric Gordon,34,22,11,547,81,175,0.463,47,111,0.423,34,64,0.531,0.597,32,38,0.842,4,33,37,47,13,8,21,33,241,LAC,2023
615,Eric Gordon,33,57,46,1669,268,564,0.475,124,301,0.412,144,263,0.548,0.585,105,135,0.778,15,98,113,154,28,18,107,63,765,HOU,2022
1334,Eric Gordon,32,27,13,789,159,367,0.433,69,210,0.329,90,157,0.573,0.527,94,114,0.825,8,50,58,71,14,13,51,44,481,HOU,2021
1958,Eric Gordon,31,36,15,1016,171,463,0.369,96,303,0.317,75,160,0.469,0.473,82,107,0.766,9,62,71,54,23,13,43,70,520,HOU,2020
2545,Eric Gordon,30,68,53,2158,384,938,0.409,216,600,0.36,168,338,0.497,0.525,119,152,0.783,17,131,148,129,41,27,90,143,1103,HOU,2019
3167,Eric Gordon,29,69,30,2154,415,970,0.428,218,608,0.359,197,362,0.544,0.54,195,241,0.809,25,145,170,154,44,27,130,116,1243,HOU,2018
3771,Eric Gordon,28,75,15,2323,412,1016,0.406,246,661,0.372,166,355,0.468,0.527,147,175,0.84,29,172,201,188,48,41,121,150,1217,HOU,2017
4445,Eric Gordon,27,45,44,1481,231,552,0.418,113,294,0.384,118,258,0.457,0.521,111,125,0.888,10,89,99,121,43,14,73,98,686,NOP,2016
4981,Eric Gordon,26,61,60,2018,285,694,0.411,141,315,0.448,144,379,0.38,0.512,107,133,0.805,28,131,159,229,50,14,122,145,818,NOP,2015
5550,Eric Gordon,25,64,64,2057,356,817,0.436,101,258,0.391,255,559,0.456,0.498,175,223,0.785,30,135,165,208,74,12,134,114,988,NOP,2014
6100,Eric Gordon,24,42,40,1264,235,584,0.402,56,173,0.324,179,411,0.436,0.45,187,222,0.842,10,67,77,137,45,8,117,75,713,NOH,2013
6623,Eric Gordon,23,9,9,310,63,140,0.45,10,40,0.25,53,100,0.53,0.486,49,65,0.754,2,23,25,31,13,4,24,20,185,NOH,2012
7417,Eric Gordon,22,56,56,2112,427,949,0.45,106,291,0.364,321,658,0.488,0.506,287,348,0.825,45,119,164,244,71,18,151,115,1247,LAC,2011
7941,Eric Gordon,21,62,60,2229,352,784,0.449,119,321,0.371,233,463,0.503,0.525,222,299,0.742,25,135,160,186,69,14,144,96,1045,LAC,2010
8444,Eric Gordon,20,78,65,2677,411,901,0.456,131,337,0.389,280,564,0.496,0.529,299,350,0.854,45,156,201,215,78,35,164,172,1252,LAC,2009
429,Devin Booker,26,53,53,1835,527,1067,0.494,111,316,0.351,416,751,0.554,0.546,306,358,0.855,46,194,240,293,51,18,145,159,1471,PHO,2023
1122,Devin Booker,25,68,68,2345,662,1421,0.466,183,478,0.383,479,943,0.508,0.53,315,363,0.868,45,297,342,329,77,26,162,180,1822,PHO,2022
1773,Devin Booker,24,67,67,2270,623,1287,0.484,126,371,0.34,497,916,0.543,0.533,340,392,0.867,34,247,281,289,53,16,207,181,1712,PHO,2021
2361,Devin Booker,23,70,70,2512,627,1283,0.489,141,398,0.354,486,885,0.549,0.544,468,509,0.919,29,268,297,456,49,18,264,213,1863,PHO,2020
2981,Devin Booker,22,64,64,2242,586,1255,0.467,135,414,0.326,451,841,0.536,0.521,393,454,0.866,39,226,265,433,56,13,264,200,1700,PHO,2019
3596,Devin Booker,21,54,54,1865,455,1054,0.432,147,384,0.383,308,670,0.46,0.501,289,329,0.878,26,218,244,253,47,14,194,168,1346,PHO,2018
4152,Devin Booker,20,78,78,2730,606,1431,0.423,147,405,0.363,459,1026,0.447,0.475,367,441,0.832,46,203,249,268,72,21,241,242,1726,PHO,2017
4679,Devin Booker,19,76,51,2108,367,867,0.423,99,289,0.343,268,578,0.464,0.48,215,256,0.84,27,160,187,200,44,20,160,225,1048,PHO,2016
309,Grayson Allen,27,72,70,1972,245,557,0.44,146,366,0.399,99,191,0.518,0.571,114,126,0.905,61,176,237,163,62,14,72,117,750,MIL,2023
967,Grayson Allen,26,66,61,1805,255,569,0.448,159,389,0.409,96,180,0.533,0.588,64,74,0.865,32,190,222,100,46,18,43,96,733,MIL,2022
1473,Grayson Allen,25,50,38,1259,173,414,0.418,107,274,0.391,66,140,0.471,0.547,79,91,0.868,19,141,160,108,46,8,48,71,532,MEM,2021
2077,Grayson Allen,24,38,0,718,117,251,0.466,57,141,0.404,60,110,0.545,0.58,39,45,0.867,8,77,85,52,10,2,33,53,330,MEM,2020
2826,Grayson Allen,23,38,2,416,67,178,0.376,32,99,0.323,35,79,0.443,0.466,45,60,0.75,3,20,23,25,6,6,33,47,211,UTA,2019
287,Drew Eubanks,25,78,28,1584,214,334,0.641,7,18,0.389,207,316,0.655,0.651,83,125,0.664,132,286,418,103,40,102,67,169,518,POR,2023
833,Drew Eubanks,24,49,9,595,84,159,0.528,1,8,0.125,83,151,0.55,0.531,59,79,0.747,64,132,196,50,13,30,46,61,228,SAS,2022
947,Drew Eubanks,24,22,22,650,137,212,0.646,4,15,0.267,133,197,0.675,0.656,40,51,0.784,66,120,186,35,18,10,35,61,318,POR,2022
1534,Drew Eubanks,23,54,3,755,116,205,0.566,2,2,1.0,114,203,0.562,0.571,77,106,0.726,74,167,241,42,18,49,45,88,311,SAS,2021
2136,Drew Eubanks,22,22,3,272,43,67,0.642,1,1,1.0,42,66,0.636,0.649,20,26,0.769,28,57,85,15,5,17,21,37,107,SAS,2020
2755,Drew Eubanks,21,23,0,113,15,26,0.577,0,0,,15,26,0.577,0.577,11,13,0.846,6,28,34,7,2,5,8,11,41,SAS,2019
553,Bradley Beal,29,50,50,1673,444,878,0.506,80,219,0.365,364,659,0.552,0.551,192,228,0.842,41,155,196,271,45,33,145,107,1160,WAS,2023
1260,Bradley Beal,28,40,40,1439,348,771,0.451,63,210,0.3,285,561,0.508,0.492,169,203,0.833,38,151,189,265,36,15,135,95,928,WAS,2022
1886,Bradley Beal,27,60,60,2147,670,1382,0.485,130,373,0.349,540,1009,0.535,0.532,408,459,0.889,72,211,283,265,69,22,187,140,1878,WAS,2021
2484,Bradley Beal,26,57,57,2053,593,1303,0.455,170,481,0.353,423,822,0.515,0.52,385,457,0.842,52,190,242,347,71,23,194,126,1741,WAS,2020
3105,Bradley Beal,25,82,82,3028,764,1609,0.475,209,596,0.351,555,1013,0.548,0.54,362,448,0.808,89,322,411,448,121,58,224,226,2099,WAS,2019
3718,Bradley Beal,24,82,82,2977,683,1484,0.46,199,530,0.375,484,954,0.507,0.527,292,369,0.791,61,302,363,373,96,36,214,160,1857,WAS,2018
4256,Bradley Beal,23,77,77,2684,637,1322,0.482,223,552,0.404,414,770,0.538,0.566,282,342,0.825,53,187,240,267,83,21,156,169,1779,WAS,2017
4791,Bradley Beal,22,55,35,1708,359,799,0.449,105,271,0.387,254,528,0.481,0.515,135,176,0.767,41,147,188,162,54,11,112,117,958,WAS,2016
5366,Bradley Beal,21,63,59,2107,363,851,0.427,106,259,0.409,257,592,0.434,0.489,130,166,0.783,57,184,241,194,76,18,123,136,962,WAS,2015
5913,Bradley Beal,20,73,73,2530,481,1149,0.419,138,343,0.402,343,806,0.426,0.479,149,189,0.788,54,219,273,243,71,18,128,153,1249,WAS,2014
6432,Bradley Beal,19,56,46,1745,282,687,0.41,91,236,0.386,191,451,0.424,0.477,125,159,0.786,43,168,211,137,50,29,90,113,780,WAS,2013
127,David Roddy,21,70,4,1258,180,420,0.429,65,212,0.307,115,208,0.553,0.506,41,65,0.631,50,143,193,59,29,19,57,107,466,MEM,2023
83,Yuta Watanabe,28,58,1,928,114,232,0.491,60,135,0.444,54,97,0.557,0.621,34,47,0.723,30,111,141,48,25,17,22,80,322,BRK,2023
739,Yuta Watanabe,27,38,4,445,56,138,0.406,27,79,0.342,29,59,0.492,0.504,24,40,0.6,18,74,92,21,11,16,19,38,163,TOR,2022
1455,Yuta Watanabe,26,50,4,723,79,180,0.439,36,90,0.4,43,90,0.478,0.539,24,29,0.828,36,123,159,40,26,19,19,57,218,TOR,2021
2084,Yuta Watanabe,25,18,0,105,15,34,0.441,3,8,0.375,12,26,0.462,0.485,3,8,0.375,7,13,20,5,5,1,2,9,36,MEM,2020
2695,Yuta Watanabe,24,15,0,174,15,51,0.294,2,16,0.125,13,35,0.371,0.314,7,10,0.7,4,27,31,8,4,1,6,11,39,MEM,2019
273,Udoka Azubuike,23,36,4,359,59,72,0.819,0,0,,59,72,0.819,0.819,7,20,0.35,31,88,119,11,6,15,18,34,125,UTA,2023
926,Udoka Azubuike,22,17,6,195,37,49,0.755,0,0,,37,49,0.755,0.755,6,11,0.545,18,53,71,0,1,11,12,25,80,UTA,2022
1619,Udoka Azubuike,21,15,0,57,4,9,0.444,0,0,,4,9,0.444,0.444,8,10,0.8,4,9,13,0,1,4,3,9,16,UTA,2021
601,Théo Maledon,21,44,7,854,102,254,0.402,28,95,0.295,74,159,0.465,0.457,63,74,0.851,14,109,123,152,37,12,59,61,295,CHO,2023
896,Théo Maledon,20,51,7,908,119,317,0.375,44,150,0.293,75,167,0.449,0.445,79,100,0.79,20,111,131,111,31,11,65,67,361,OKC,2022
1581,Théo Maledon,19,65,49,1778,226,614,0.368,105,313,0.335,121,301,0.402,0.454,101,135,0.748,25,186,211,227,56,11,141,126,658,OKC,2021
430,Damion Lee,30,74,5,1506,200,452,0.442,110,247,0.445,90,205,0.439,0.564,94,104,0.904,39,186,225,99,30,7,78,118,604,PHO,2023
1150,Damion Lee,29,63,5,1256,169,383,0.441,63,187,0.337,106,196,0.541,0.523,66,75,0.88,27,176,203,63,39,6,38,95,467,GSW,2022
1796,Damion Lee,28,57,1,1079,128,274,0.467,77,194,0.397,51,80,0.638,0.608,40,44,0.909,22,158,180,73,38,8,30,89,373,GSW,2021
2382,Damion Lee,27,49,36,1423,213,511,0.417,85,239,0.356,128,272,0.471,0.5,110,126,0.873,32,207,239,133,50,6,67,116,621,GSW,2020
3017,Damion Lee,26,32,0,375,56,127,0.441,27,68,0.397,29,59,0.492,0.547,19,22,0.864,8,56,64,13,13,0,11,28,158,GSW,2019
3711,Damion Lee,25,15,11,404,62,152,0.408,15,60,0.25,47,92,0.511,0.457,22,29,0.759,11,60,71,29,19,1,14,25,161,ATL,2018
